B,B,B,B,B,B,B,B,B,B,B,B,B,B,B,B,B,B,B,B,B,B,B
B,O,O,O,O,O,O,O,O,O,O,O,O,O,O,O,O,O,O,O,O,O,B
B,O,O,O,O,O,O,O,O,O,O,O,O,O,O,O,O,O,O,O,O,O,B
B,O,D,D,D,D,D,D,D,D,D,D,D,D,D,D,D,D,D,D,D,O,B
B,O,O,O,O,O,O,O,O,O,O,O,O,O,O,O,O,O,O,O,O,O,B
B,O,O,O,O,O,O,O,O,O,O,O,O,O,O,O,O,O,O,O,O,O,B
B,O,O,O,O,O,O,O,O,O,O,O,O,O,O,O,O,O,O,O,O,O,B
B,O,O,O,O,O,O,O,O,O,O,O,O,O,O,O,O,O,O,O,O,O,B
B,O,O,O,O,O,O,O,O,O,O,O,O,O,O,O,O,O,O,O,O,O,B
B,B,B,B,B,B,B,B,B,B,B,B,B,B,B,B,B,B,B,B,B,B,B
